11111111111111111111111111111111111
1E00000000C0000C00000C00000CC000011
10100001000000001010010000000101011
10100100100010000010010000000100001
1P0000001C00C0000000C0CC00000000C11
10100100100010100000000000000101011
11111111111111111111111111111111111